без — с род. пад. (без света, безо всякой причины)
безо — с род. пад. (без света, безо всякой причины)
благодаря — с дат. пад. (благодаря наводнению)
близ — с род. пад. (близ берега)
в — с вин. пад. (в дом) и предл. (в доме, во мгле)
в виде — с род. пад. (в виде исключения)
в заключение — с род. пад. (в заключение доклада)
в отличие от — с род. пад. (в отличие от статьи)
в продолжение — с род. пад. (а продолжение разговора)
в связи с — с тв. пад. (в связи с крушением)
в силу — с род. пад. (в силу обстоятельств)
в случае — с род. пад. (в случае поражения)
в течение — с род. пад. (в течение хода)
в целях — с род. пад. (в целях защиты)
вблизи — с род. пад. (вблизи пня)
ввиду — с род. пад. (ввиду чего-то)
вдоль — с род. пад. (вдоль ручья)
включая — с вин. пад. (включая стол)
вместо — с род. пад. (вместо брата)
вне — с род. пад. (вне игры)
внутри — с род. пад. (внутри дерева)
во — с вин. пад. (в дом, во мглу) и предл. (в доме, во мгле)
возле — с род. пад. (возле дома)
вокруг — с род. пад. (вокруг дома)
вопреки — с дат. пад. (вопреки правилам)
впереди — с род. пад. (впереди очереди)
вроде — с род. пад. (вроде молод)
вслед за — тв. пад. (вслед за врагом)
вследствие — с род. пад. (вследствие болезни)
для — с род. пад. (для матери)
для-ради — с род. пад. (для-ради важности)
до — с род. пад. (до леса)
за — с вин. пад. (за лес) и твор. (за деревней)
за исключением — с род. пад. (за исключением Валеры)
за счёт — с род. пад. (за счёт победы)
за-ради — с род. пад. (за-ради денег)
из — с род. пад. (из квартиры, изо всех сил)
изо — с род. пад. (из квартиры, изо всех сил)
исключая — с вин. пад. (исключая проблему)
из-за — с род. пад. (из-за поворота)
из-под — с род. (из-под стола)
к — с дат. пад. (к реке, ко мне, ко всякому)
ко — с дат. пад. (к реке, ко мне, ко всякому)
кончая — с тв. пад. (кончая никем)
кроме — с род. пад. (кроме него)
меж — с род. пад. (между рядов) и твор. пад. (между деревьями)
между — с род. пад. (между рядов) и твор. пад. (между деревьями)
мимо — с род. пад. (мимо скалы)
на — с вин. пад. (на коня) и предл. пад. (на коне)
на-над — с твор. пад. (на-над цветком)
навстречу — с дат. пад. (навстречу ветру)
над — с твор. пад. (над крышей, надо мной)
надо — с твор. пад. (над крышей, надо мной)
наперекор — с дат. пад. (наперекор судьбе)
наподобие — с род. пад. (наподобие чего-то)
напротив — с род. пад. (напротив солнца)
насчёт — с род. пад. (насчёт того обвала)
начиная с — с род. пад. (начиная с понедельника)
не считая — с род. пад. (не считая яблока)
невзирая на — с вин. пад. (невзирая на яблоко)
несмотря на — с вин. пад. (несмотря на яблоко)
о — с вин. пад. (о бок, об стекло) и предл. (о подруге, обо мне)
об — с вин. пад. (о бок, об стекло) и предл. (о подруге, обо мне)
обо — с вин. пад. (о бок, об стекло) и предл. (о подруге, обо мне)
от — с род. пад. (от дяди, ото всех)
ото — с род. пад. (от дяди, ото всех)
перед — с твор. пад. (перед садом, передо мной, предо мной)
передо — с твор. пад. (перед садом, передо мной, предо мной)
пo — с вин. пад. (по пояс), дат. пад. (по полям) и предл. пад. (тосковать по нём)
по мере — с род. пад. (по мере приближения)
по поводу — с род. пад. (по поводу инцедента)
по причине — с род. пад. (по причине яблока)
по сторонам — с род. пад. (по сторонам яблока)
по части — с род. пад. (по части яблока)
по-за — с твор. пад. (по-за лесом)
по-над — с твор. пад. (по-над гладью моря)
по-под — с твор. пад. (по-под снегом)
поверх — (поверх яблока)
под — с вин. пад. (под руки) и твор. пад. (под землёй, подо мной)
подо — с вин. пад. (под руки) и твор. пад. (под землёй, подо мной)
позади —  с род. пад. (позади яблока)
помимо — с род. пад. (помимо яблока)
поперёк — с род. пад. (поперёк яблока)
после — (после яблока)
посередине — (посередине площади)
посреди — (посреди площади)
пред — с твор. пад. (перед садом, передо мной, предо мной)
предо — с твор. пад. (перед садом, передо мной, предо мной)
при — с предл. пад. (при церкви) про — с вин. пад. (быль про орла)
ради — с род. пад. (ради внука)
с — с род. пад. (c крыши), с вин. пад. (размером c гору) и твор. пад. (c другом, со мною)
сверху — с род. пад. (сверху крыши)
свыше — с род. пад. (свыше крыши)
сзади — с род. пад. (сзади яблока)
сквозь — с вин. пад. (сквозь стекло)
со — с род. пад. (c крыши), с вин. пад. (размером c гору) и твор. пад. (c другом, со мною)
со стороны — с род. пад. (со стороны яблока)
согласно — с дат. пад. (согласно яблоку)
соответсвенно — с дат. пад. (соответственно документу)
спустя — с вин. пад. (спустя день)
среди — с род. пад. (среди поля)
у — с род. пад. (у реки)
через — с вин. пад. (через порог)
чрез — с вин. пад. (через порог)